prévenir: to warn
ramener: to bring back
la lutte: the fight
chômage: unemployment
nuire: to harm
mon propos: my point
viser: to aim
une cible: a target
toutefois: nevertheless
car: because
perdurer: to last, persist
or: however
le pire: the worst  
l'épargne: savings
la quiétude: tranquility, piece of mind
bien que: although
sera passager: will be temporary
selon moi: in my opinion
deviez reporter: postpone
annuler: cancel
incontournable: unavoidable
les écrans: screens  
du jamais vu: never saw the like (?) 
accablé: overwhelmed
imprévisible: unpredictable
le Royaume-Uni: UK
eux qui: those
vergogne: shame
des coups fourrés: dirty tricks
d'autant: especially 
indocile: rebel
sans boussole: without a compass
en passant: including
la plupart: most [of] 
à l’échelle: at scale
au pire: at worst
racoleur: eye-catching
un pourboire: tip
parfois: sometimes
l'enjeu: challange
actuel: current
désormais: from now on
au sein: within
le soutien: support
la mollesse: softness
durement: harshly
forcément: inevitably   
ainsi: thus, as well as
pendant lequel: during which  
comme si la vie: as if life [wasn't already hard enough]
en outre: moreover
le fait est que: the fact is
puisque: because 
rebattre les cartes: shuffle the cards
en fin de compte: at the end of the day
or: however 
pourtant: however
autant de gestes: so many gestures
parmi d'autres: among others
du pétrin: trouble
lui-même: himself
